30002020200000220002
20020002020200000000
02200002000200000000
22020202002000000000
00220020002020200002
20200000200022000002
00000020020000000000
00002000000202002000
00000000020020000020
00020000220000200002
00200000002020200000
00022200000000022020
20200000000002200000
02000020020000002200
00002000000000020000
02002202220000200200
00200220022020220000
20020200200200020000
00002000200222000200
02000000000000022000
19
19